        1111111111111111111111111
111111111011000001110000000000001
100000000011000001110111111111111
10000000000000001101010010001
11000001110101011111011110N0111
11110111 1110101 101111010001
11111111 1111111 111111111111